7.705317213947390220e-01
3.957684324111467311e-01
3.824738266659371555e-01
3.680640672092084786e-01
3.724748615865354218e-01
3.523517818730554363e-01
3.539936072848461346e-01
3.609354883800318103e-01
3.620499624146355511e-01
3.447894242258719433e-01
3.255821285240443896e-01
3.173282397566018487e-01
3.345211409860187057e-01
3.023704828303537262e-01
3.086398940395425616e-01
2.913745269179344177e-01
3.231299099730856605e-01
2.744957108924418465e-01
2.639388121664524300e-01
2.742129852558359837e-01
2.876553312495902515e-01
2.765000979657526448e-01
2.512479620767228417e-01
2.636352167085365128e-01
2.549566707953258571e-01
2.495879196642357689e-01
2.417170877625912928e-01
2.603145263353247585e-01
2.300819473318111708e-01
2.399410868500485849e-01
2.260490613771073687e-01
2.249362825887438744e-01
2.287697287437356619e-01
2.232449441412348856e-01
2.348966287793936569e-01
2.317299468465793266e-01
2.250277383321965252e-01
2.122503043600806605e-01
2.250805820763847054e-01
2.202609036531713305e-01
2.127425913273552349e-01
2.167076973911420679e-01
2.108281835729693132e-01
2.090321951718241977e-01
2.022084327391636127e-01
2.149538272324903465e-01
2.059507490124231621e-01
2.142137973396866513e-01
2.195592612763981877e-01
2.391444587413175671e-01
2.022364477960415796e-01
2.087549716050242088e-01
2.026441240108307618e-01
2.088349340506541751e-01
2.024662923113799418e-01
2.074898696975943369e-01
1.998741543541351917e-01
2.075516924078081860e-01
2.045168793035878063e-01
1.994921320658407105e-01
1.966339223316790064e-01
1.948156146079669804e-01
2.081615415160302796e-01
2.062986700807088736e-01
1.929713259738536635e-01
1.972472914069155203e-01
1.878749264703120647e-01
1.958796337430859791e-01
1.902119192536230463e-01
1.885955614946138725e-01
1.923729998645959116e-01
2.084439823105011524e-01
1.834928352431750564e-01
1.954680617162842804e-01
1.905029499972308027e-01
1.773286333698549377e-01
1.928670785125390919e-01
1.843271393466878738e-01
1.920702469983586458e-01
1.838986286870491482e-01
1.938775203156250515e-01
1.795068908528781315e-01
1.942815170427899252e-01
1.726831106216083211e-01
1.868612005570788326e-01
1.872682558717551071e-01
1.802924133653258099e-01
1.709082331094476936e-01
1.919451807200172888e-01
1.829030877876061112e-01
1.785409458533481208e-01
1.711193760052139301e-01
1.823665975144615758e-01
1.786231653281935838e-01
1.808916927073840608e-01
1.764425187567134068e-01
1.619250776683106852e-01
1.659841576660120999e-01
1.773111085648889917e-01
1.827466233001079077e-01
1.613355780549255436e-01
1.617341164039608759e-01
1.691185581739302057e-01
1.740123544072295358e-01
1.621519829893921516e-01
1.706907873306377499e-01
1.691106384367118687e-01
1.662576755899705938e-01
1.696222218374411339e-01
1.612844382539207477e-01
1.658597026756148396e-01
1.550060330947608256e-01
1.694955245488219686e-01
1.755234937057083000e-01
1.732223543349975525e-01
1.463774013068573077e-01
1.750683510239109675e-01
1.499488967344348722e-01
1.578063388757499630e-01
1.526309681481417269e-01
1.583334300621056234e-01
1.630476747535996862e-01
1.448960768541804056e-01
1.601877443837346759e-01
1.715135469112867295e-01
1.597071493895333427e-01
1.624516662808112022e-01
1.643559900008969843e-01
1.558548525895601389e-01
1.581795194818649830e-01
1.592562070093405113e-01
1.552505535108071877e-01
1.657782188766164511e-01
1.533621504074997310e-01
1.545595712085932882e-01
1.583302636895282667e-01
1.421074523372046761e-01
1.357985002621088511e-01
1.529273945010370672e-01
1.494118723420449213e-01
1.522157139064353182e-01
1.551408989102016356e-01
1.521271464219431935e-01
1.465016012206489526e-01
1.530474722109459174e-01
1.364520346354923253e-01
1.483557970021609773e-01
1.508371528559996622e-01
1.406919535893348949e-01
1.410363480310749262e-01
1.449800396683039450e-01
1.492356547372944431e-01
1.482062109918506065e-01
1.504131316954706865e-01
1.366421003216578556e-01
1.454577802783913187e-01
1.384022418455577164e-01
1.437419658595765204e-01
1.424284228986060219e-01
1.414106741363619635e-01
1.371043984766727730e-01
1.440437647525543152e-01
1.466686930369447694e-01
1.356695219138522313e-01
1.438622368016728714e-01
1.425180422579064854e-01
1.352932267166949976e-01
1.343718733914472385e-01
1.362429016442210650e-01
1.345231617122520651e-01
1.398433359638776297e-01
1.332761835214900381e-01
1.364763018870611133e-01
1.304561058726207701e-01
1.370881636109617108e-01
1.321010297969167635e-01
1.297070869279128569e-01
1.367008050880682279e-01
1.344177436589458763e-01
1.350170324338071104e-01
1.291189082702736690e-01
1.324244372914602785e-01
1.330295570700624763e-01
1.404953993396994560e-01
1.337153342127063993e-01
1.347624282456106604e-01
1.285604565829774615e-01
1.330543790426519102e-01
1.262469159048280609e-01
1.317095815123599245e-01
1.271455530491140129e-01
1.329592813634210280e-01
1.337913102067914972e-01
1.245259246156539407e-01
1.274681400507688411e-01
1.239193590932790162e-01
1.263911673638187794e-01
1.257134100721206127e-01
1.257526759426166874e-01
1.300123853746939506e-01
1.255140970242612231e-01
1.237671481008515012e-01
1.256724485736570307e-01
1.244871954169170375e-01
1.267821537123786091e-01
1.206907487025967313e-01
1.227502405551480630e-01
1.201912454018990162e-01
1.208621061510509881e-01
1.223164184271921390e-01
1.253154013305902426e-01
1.182716523607571929e-01
1.198122827865091417e-01
1.171801517246130048e-01
1.193962261402680552e-01
1.240672437773074621e-01
1.172292339397065369e-01
1.176113200684388432e-01
1.159037423561568581e-01
1.190535051702165253e-01
1.167813647791375309e-01
1.142570526028672817e-01
1.162539026987405438e-01
1.180826699775126276e-01
1.104774977161008670e-01
1.133257663038409746e-01
1.106154424540790465e-01
1.059312096739440795e-01
1.045768056662730178e-01
1.044643374113940898e-01
9.773491427049409153e-02
9.896583945065000332e-02
1.006404978970502628e-01
9.054454925159613476e-02
1.011030727238566851e-01
9.387970060386040261e-02
9.665185722786887035e-02
8.290151095155764982e-02
8.098931353953149614e-02
7.736097756014377602e-02
7.612629441923841889e-02
8.361817098418135308e-02
7.774633455354675038e-02
7.252387820202627067e-02
7.371524573407239878e-02
7.111238809417427809e-02
7.729878629454307870e-02
6.531684562839844277e-02
7.500871896390216842e-02
7.151824778095347557e-02
6.869154113566180997e-02
6.377006345026102474e-02
6.192115153944878492e-02
6.708211726250333518e-02
7.003397663399853201e-02
5.464837208769663529e-02
6.013074949625189791e-02
5.671554434682345852e-02
5.412791235355177144e-02
5.714358360776792406e-02
5.593676869498772491e-02
5.634273625694698195e-02
5.697631695635478610e-02
5.432732233872498984e-02
5.120770478201455006e-02
5.509081153978052925e-02
5.118680983684083252e-02
5.184992785108517160e-02
5.548835854393855543e-02
5.071938148969899057e-02
5.168205247415850329e-02
4.662858201104595757e-02
4.564806571299279137e-02
4.256496437154078105e-02
4.511001389962333852e-02
4.591462945473599039e-02
4.469835246571075144e-02
4.742209356145956484e-02
4.283043385948985537e-02
4.359243083572773847e-02
4.680687710901515475e-02
4.520841724646024878e-02
4.229785364831188665e-02
4.276908259856065930e-02
4.366156783833076427e-02
4.176590111154062507e-02
4.231825224224500942e-02
4.135171109296663372e-02
4.193164502201533056e-02
4.076182485233279668e-02
4.032171791172183689e-02
3.909760463600518016e-02
4.219297937399213438e-02
4.053447997689040017e-02
4.097867770031393686e-02
3.823592544786263980e-02
3.751398813723942627e-02
3.784376839815385696e-02
3.775049029791262278e-02
3.824363407336842102e-02
