8.248637710824424651e-01
3.955399346940311478e-01
3.785626882020338146e-01
3.650469207101397773e-01
3.688890002024026726e-01
3.485099445890497138e-01
3.490999162381078214e-01
3.564776737380910832e-01
3.591362947483121570e-01
3.405311944859999440e-01
3.192877967784434334e-01
3.124019446196379390e-01
3.279175656813162476e-01
2.993798511999624656e-01
3.063022069724989360e-01
2.873360806777153220e-01
3.178045213590433571e-01
2.711017220844457176e-01
2.604076294895307786e-01
2.706665410671705296e-01
2.835420685049928058e-01
2.722056823840111606e-01
2.480647343820260031e-01
2.600562241710262512e-01
2.517492885206952247e-01
2.455208454235100479e-01
2.390096052193347309e-01
2.561257304508745003e-01
2.270383133380501350e-01
2.374546855504130194e-01
2.229412192455780262e-01
2.222815406083324674e-01
2.260479789273238393e-01
2.204301912015602938e-01
2.318872113654642797e-01
2.286857575914006124e-01
2.226943021111282284e-01
2.102071454863489453e-01
2.217494011661152731e-01
2.173346268909948920e-01
2.101273365134810334e-01
2.139667947535161541e-01
2.083916493588023611e-01
2.065109405068703552e-01
1.996422137743160963e-01
2.122011454844916212e-01
2.033222762338909029e-01
2.116631667187184596e-01
2.166112834196767811e-01
2.357867742854136139e-01
1.997246440546012192e-01
2.062949240575601972e-01
1.999228893882698532e-01
2.060317367499257257e-01
1.996378152274791151e-01
2.052223190481280157e-01
1.973033422857154995e-01
2.053433291935994331e-01
2.018916214551822741e-01
1.969497564766142239e-01
1.943559050927927412e-01
1.922841232407976053e-01
2.062250325341283552e-01
2.046093868988531628e-01
1.908158542841305039e-01
1.956880141279579710e-01
1.857403124004234629e-01
1.936272679195727708e-01
1.878319006275247782e-01
1.864231850216050146e-01
1.902162256616133362e-01
2.059789150401397928e-01
1.817936936554349625e-01
1.935903398665013153e-01
1.880973438053955282e-01
1.752182281679577347e-01
1.908257307829680227e-01
1.820602504835452662e-01
1.900059496454986618e-01
1.819011280014191101e-01
1.921857239149602770e-01
1.778830214231102436e-01
1.929198767116040436e-01
1.711151318233690155e-01
1.854203062568917648e-01
1.857510702753508436e-01
1.784269873282791630e-01
1.691480708067063798e-01
1.893465780181649294e-01
1.809007338351673599e-01
1.770275989800323690e-01
1.692738252289501255e-01
1.799410541438394018e-01
1.769738888896909834e-01
1.790566088884701090e-01
1.747531735326772750e-01
1.601859484925682031e-01
1.645631687508689045e-01
1.754240357581479948e-01
1.813688089588174068e-01
1.600379821832901284e-01
1.599254100457017935e-01
1.674052819655633129e-01
1.721329920545772163e-01
1.605240589444651977e-01
1.688744685256186873e-01
1.673119773651346731e-01
1.652007652101693258e-01
1.678527930406508717e-01
1.592545962076128141e-01
1.648346038236294386e-01
1.536131166013670613e-01
1.674188300599286638e-01
1.739367212916229921e-01
1.708897945229654047e-01
1.450232687647695917e-01
1.734515511281328470e-01
1.486292233161720100e-01
1.562203566279308231e-01
1.512268201712473059e-01
1.564808663900619790e-01
1.615493387765722377e-01
1.434990612399063004e-01
1.593741098050902028e-01
1.707088648629041250e-01
1.575488077085695215e-01
1.606952609103403096e-01
1.632924185444911414e-01
1.540120255753949785e-01
1.564142953466486075e-01
1.570429390963213045e-01
1.539500472998177605e-01
1.638012044269729628e-01
1.517804382989803857e-01
1.528910011306037209e-01
1.565788532020869206e-01
1.407047535074345823e-01
1.344354560575735380e-01
1.508553102198574303e-01
1.484149318418385155e-01
1.502154632574982107e-01
1.532720114253921240e-01
1.500683765950394377e-01
1.449002774823227035e-01
1.515156099457799777e-01
1.350764494205330679e-01
1.468441255528617762e-01
1.495156286169349313e-01
1.391607130751197630e-01
1.396068181060714508e-01
1.436180019774186689e-01
1.481267296329692451e-01
1.468571535047189791e-01
1.488497047972532072e-01
1.352796134527450844e-01
1.438025824265715402e-01
1.368628347407520596e-01
1.421578974589521593e-01
1.410563848682759858e-01
1.400755445162455148e-01
1.356161218780426447e-01
1.427428295628891952e-01
1.452454978439174926e-01
1.341561875708493223e-01
1.429062876160498152e-01
1.409469444948582006e-01
1.342600356695460573e-01
1.329823189311557241e-01
1.351623001841851246e-01
1.326885635194219315e-01
1.383109091470638985e-01
1.319531812528033365e-01
1.347692337289544406e-01
1.292379541253602104e-01
1.352727200605987057e-01
1.307715433615225242e-01
1.282181586656305494e-01
1.350412207805080089e-01
1.331025929730615398e-01
1.338714155839917097e-01
1.276845529583501282e-01
1.311607343455155616e-01
1.318123771774548092e-01
1.388561341543624317e-01
1.321499410188860246e-01
1.334627842047700075e-01
1.273694252296362350e-01
1.312939665291780189e-01
1.249044648659082130e-01
1.301832851850324158e-01
1.257786185791095190e-01
1.315683136613648718e-01
1.325767887503276621e-01
1.232976226067101500e-01
1.260969973962615953e-01
1.231094673965816150e-01
1.251274274823106492e-01
1.244711097835758534e-01
1.243705539837663548e-01
1.285334404281995857e-01
1.241298664614190334e-01
1.227535813310999951e-01
1.240359365779124673e-01
1.231489558600717127e-01
1.252764534159206966e-01
1.195699204495291601e-01
1.214691648305750160e-01
1.188830035152258630e-01
1.192894531896820792e-01
1.211382833481938759e-01
1.239823826163271303e-01
1.170911126114703993e-01
1.187309742617754238e-01
1.158674590565540174e-01
1.182340496553131032e-01
1.227167333211795774e-01
1.160187399727694718e-01
1.165001477080362807e-01
1.147674824099665786e-01
1.175111240373901411e-01
1.155563399747565889e-01
1.130797213265373330e-01
1.152606515420807748e-01
1.169396913483922856e-01
1.094293249449060229e-01
1.119814050832280417e-01
1.093404660530296335e-01
1.050335077568888692e-01
1.037589968101661902e-01
1.036939813215055628e-01
9.670050402896271380e-02
9.778456784968758697e-02
9.969907171541342317e-02
8.989212114455891189e-02
9.995140884715465746e-02
9.264936369648318903e-02
9.592355862029908198e-02
8.253700981192567399e-02
8.049439865704856312e-02
7.640526491320795421e-02
7.512339893498538868e-02
8.219098823294503087e-02
7.656120990839913876e-02
7.151241854040159274e-02
7.281158461844847163e-02
7.024988389608484429e-02
7.604188255988705847e-02
6.460097772299230878e-02
7.375708582974901950e-02
7.055149096305723955e-02
6.796906060728899468e-02
6.307352385368704406e-02
6.125789245153651086e-02
6.623444304209386013e-02
6.945185694027186663e-02
5.411972720204726028e-02
5.954214141066013766e-02
5.634430974066533676e-02
5.383716982381165500e-02
5.705868754001265641e-02
5.560636353293824802e-02
5.629908485427199960e-02
5.650954666636585216e-02
5.398876881011313578e-02
5.099868418671834464e-02
5.465380563774364930e-02
5.097035508873055953e-02
5.158199899611465994e-02
5.523618290741226511e-02
5.040303755919506301e-02
5.139383153765703788e-02
4.636521801125419173e-02
4.545398754524757057e-02
4.224271274539699583e-02
4.481522546129668855e-02
4.548608855427713898e-02
4.428781521589966741e-02
4.697775376578332968e-02
4.244213318739684104e-02
4.319072200997191996e-02
4.624933621754157009e-02
4.471920137027749625e-02
4.187529828351991418e-02
4.223727792110523738e-02
4.322395888257794805e-02
4.131190701550228883e-02
4.185319871391618429e-02
4.094221100824120552e-02
4.144935983256149703e-02
4.029720947376371626e-02
3.977198091818502645e-02
3.865017722214192375e-02
4.164222092755760080e-02
4.002487892026288657e-02
4.047067845017465054e-02
3.773788739230058559e-02
3.700445749499420983e-02
3.737951253611238034e-02
3.724058191960297887e-02
3.772299809591200814e-02
