7.622830852314278482e-01
3.918130337824056175e-01
3.786881996157728802e-01
3.644135989156770394e-01
3.687859711455709899e-01
3.488666826192243775e-01
3.505026094707441864e-01
3.573707119366268947e-01
3.584585994666005249e-01
3.413841127429479427e-01
3.223892504786267654e-01
3.142042205105592956e-01
3.312419657354001568e-01
2.993766840961244458e-01
3.055768714458854118e-01
2.885011659544191032e-01
3.199518645251238635e-01
2.717846930946832829e-01
2.613347364244637538e-01
2.715063194249883183e-01
2.848199108500539256e-01
2.737780410566447720e-01
2.487673147868962875e-01
2.610346546511591037e-01
2.524391777629469424e-01
2.471327117563765774e-01
2.393269915271688253e-01
2.577532690800266590e-01
2.278115638980159063e-01
2.375665399947284318e-01
2.238196488607812895e-01
2.227134671568134772e-01
2.265092491551681797e-01
2.210406426294350413e-01
2.325777565347559583e-01
2.294430899491280706e-01
2.228007954671794855e-01
2.101482323842284172e-01
2.228630880882710719e-01
2.180875576388688619e-01
2.106413177042095741e-01
2.145680292704958969e-01
2.087442672546998834e-01
2.069670860966046633e-01
2.002120106400530897e-01
2.128318161324218583e-01
2.039175267756721255e-01
2.120971658715495312e-01
2.173931489296165587e-01
2.367865914363919966e-01
2.002392010004432066e-01
2.066920220024055788e-01
2.006448949376742064e-01
2.067746165863893759e-01
2.004699141614967040e-01
2.054376465578874045e-01
1.979011210716432878e-01
2.054982593765965204e-01
2.024979633129673218e-01
1.975226348932878351e-01
1.946903637575882473e-01
1.928927734678174133e-01
2.060992914401454656e-01
2.042525756598254916e-01
1.910631676284987313e-01
1.952904113786823881e-01
1.860175231908574589e-01
1.939433608526064945e-01
1.883336000972324065e-01
1.867313298224299034e-01
1.904708375165491963e-01
2.063841937868683418e-01
1.816748982594336981e-01
1.935321587655279285e-01
1.886219766220928740e-01
1.755764509792681061e-01
1.909588213780044064e-01
1.825065369959230910e-01
1.901701871351695328e-01
1.820796176699208679e-01
1.919556633465819839e-01
1.777280606329441071e-01
1.923523185797679502e-01
1.709719595993742514e-01
1.850069972008098751e-01
1.854107456166803058e-01
1.785081435500839586e-01
1.692167530089248861e-01
1.900517150575732062e-01
1.810940807708251721e-01
1.767706703992537598e-01
1.694266377867739981e-01
1.805671870432518089e-01
1.768534269275856552e-01
1.791011263604885273e-01
1.746949871565088852e-01
1.603232185413807909e-01
1.643385260331410025e-01
1.755568680985842289e-01
1.809329351203309288e-01
1.597351981901828089e-01
1.601348621011884077e-01
1.674445052159789227e-01
1.722910248616963125e-01
1.605467424670487253e-01
1.690020427751688370e-01
1.674375186317864639e-01
1.646056676444448141e-01
1.679436935824744626e-01
1.596918923803317680e-01
1.642113567594392920e-01
1.534699021482173187e-01
1.678213365008065783e-01
1.737841263643385425e-01
1.715134564787149374e-01
1.449271689364571569e-01
1.733338355466171599e-01
1.484626048600967974e-01
1.562441351329103001e-01
1.511186998751428423e-01
1.567686211363768789e-01
1.614321814321073578e-01
1.434610863020758520e-01
1.585940034853087488e-01
1.698064580467747997e-01
1.581316611281147755e-01
1.608447137898133261e-01
1.627230654068199112e-01
1.543147324779887142e-01
1.566153764172836527e-01
1.576857777795306059e-01
1.537110529242106394e-01
1.641402070077113140e-01
1.518443462381392217e-01
1.530306611486055290e-01
1.567644752424072474e-01
1.407004047691086113e-01
1.344541455032648991e-01
1.514188415796300646e-01
1.479277229741399746e-01
1.507135593688782305e-01
1.536081790464159935e-01
1.506264628819477536e-01
1.450525981270604781e-01
1.515323158951453197e-01
1.351012702479406635e-01
1.468873556197425601e-01
1.493419969615377152e-01
1.393003468850144699e-01
1.396402794821762772e-01
1.435438597413860595e-01
1.477543875161144438e-01
1.467376396105981029e-01
1.489246347482189592e-01
1.352893039584159851e-01
1.440197542723682111e-01
1.370336134860545008e-01
1.423203873873492842e-01
1.410178587852436716e-01
1.400099185145931568e-01
1.357482373852420821e-01
1.426163361626274773e-01
1.452162379145990057e-01
1.343279599568542038e-01
1.424331737705218925e-01
1.411085727130189371e-01
1.339506262108499657e-01
1.330420498678713537e-01
1.348912785082687638e-01
1.331962761641652393e-01
1.384602270376535105e-01
1.319566518804173305e-01
1.351286097567666322e-01
1.291637265525850120e-01
1.357354363587535417e-01
1.307933145973049494e-01
1.284249053647120720e-01
1.353503929336129785e-01
1.330867178922082172e-01
1.336783182059909092e-01
1.278420622977945453e-01
1.311128299085446425e-01
1.317114332667839449e-01
1.391068379084269280e-01
1.323938347583199782e-01
1.334278003853044403e-01
1.272867625280294790e-01
1.317414393901457093e-01
1.249978710701804135e-01
1.304077486473101122e-01
1.258877667747897999e-01
1.316435981863810778e-01
1.324655421354152540e-01
1.232929487195279922e-01
1.262071700421748266e-01
1.226882645561371277e-01
1.251398931544872029e-01
1.244686990424438700e-01
1.245089705297608429e-01
1.287270511856969391e-01
1.242727983972908568e-01
1.225396125818844217e-01
1.244320891728555728e-01
1.232557057506508263e-01
1.255293890557907244e-01
1.194950495099211946e-01
1.215355487816311697e-01
1.190024150098547562e-01
1.196692116604542999e-01
1.211050354772143928e-01
1.240755775874411576e-01
1.171007412635249878e-01
1.186249728992949254e-01
1.160214772309969972e-01
1.182138861030524180e-01
1.228400767447403868e-01
1.160690463803432659e-01
1.164463183302202332e-01
1.147560677755578018e-01
1.178783938311684237e-01
1.156258013352383790e-01
1.131262552039122848e-01
1.151012959441652939e-01
1.169132729739318644e-01
1.093832043493971479e-01
1.122059522633567230e-01
1.095220379278431660e-01
1.048808746913700990e-01
1.035392154054141367e-01
1.034273974988379613e-01
9.676790929824849452e-02
9.798799353525226852e-02
9.964350740781720284e-02
8.964562795964288455e-02
1.001035587839138319e-01
9.295320703337589530e-02
9.569262136578743361e-02
8.207614100825640080e-02
8.018436960554049808e-02
7.659692487299994690e-02
7.537506055661741255e-02
8.279626117501821814e-02
7.698072241734207899e-02
7.180875413763669612e-02
7.298712978300489485e-02
7.040988925016589128e-02
7.653836754702583733e-02
6.467083580332037840e-02
7.427114819113257715e-02
7.081273290282689981e-02
6.801185038279926320e-02
6.313932834158617058e-02
6.130857251837481398e-02
6.641977272301130553e-02
6.933945802092138233e-02
5.410717487921593710e-02
5.953532809558335914e-02
5.615210132759616141e-02
5.358954039086116089e-02
5.657299671086402082e-02
5.538070505502185048e-02
5.577974532153112674e-02
5.641122143485664125e-02
5.378743470129039583e-02
5.069771770497116803e-02
5.454427350418825787e-02
5.067710627048609834e-02
5.133410785835880452e-02
5.493599672494225983e-02
5.021535112999701844e-02
5.116811428322560334e-02
4.616492978443770961e-02
4.519352595563288361e-02
4.214253738532590388e-02
4.466186182265871607e-02
4.545976854616454177e-02
4.425547434847779127e-02
4.695231598467037443e-02
4.240601254170070500e-02
4.316052360960316581e-02
4.634438383142912288e-02
4.476122519850765646e-02
4.187910055240794127e-02
4.234670982530835265e-02
4.322932838314259146e-02
4.135278205331242157e-02
4.189972026269296601e-02
4.094228889824776813e-02
4.151715149127096355e-02
4.035885277470820792e-02
3.992399809131812888e-02
3.871110285198269690e-02
4.177655729243853755e-02
4.013423117346210517e-02
4.057397090012127006e-02
3.785854658402249689e-02
3.714394359130780005e-02
3.746997334438887522e-02
3.737808447852184607e-02
3.786640403013285389e-02
